date,event_type,attendees,food_prepared,food_consumed,wasted_food
2021-01-01,wedding,200,500,400,100
2021-02-14,birthday,50,120,100,20
2021-03-10,corporate,150,300,250,50
2021-04-05,family,30,80,60,20
2021-05-20,festival,300,600,520,80
2021-06-15,wedding,250,550,450,100
2021-07-10,birthday,40,100,90,10
2021-08-25,corporate,180,400,370,30
2021-09-15,family,20,70,60,10
2021-10-31,festival,500,1200,1050,150
